Configuration: game_config
Timestamp: 20250725_130122
Sample: 0
Total rooms: 10
Disconnected rooms: []
Width: 80, Height: 40
Room size: 4-10
Max rooms: 15

Map (numbers = room centers, X = disconnected areas):
################################################################################
################################################################################
################################################################################
###################.....########################################################
###################.....########################################################
###################.....####....#######+..######################################
###############......1..####..............######################################
###############.###...........2..........7######################################
###############.###.....####..............######################################
###############.############.###################################################
########....##..############.###################################################
########....##..############.###################################################
########....##..############.###################################################
########........############.###################################################
########..6....5.###########.###################################################
########.........###########.###################################################
########....+#...#########.....#################################################
########....##...#########.....#################################################
##############...#########..9..#################################################
##############...#########.....#################################################
##############...###########.###################################################
##############...###########.#######..#################..#######################
###############...##########.#######..#################..#######################
###############...##########.#######..################+..#######################
###############...##########.######+.....................#######################
###############...##########.........0..................4#######################
##############+...+#################.....................#######################
#############......#################...#######...........#######################
#############......################+...#####........##+..#######################
#############...8..################...###........###############################
#############......###############+...........##################################
#############......##############...........####################################
#################################...3....#######################################
#################################......+########################################
################################################################################
################################################################################
################################################################################
################################################################################
################################################################################
################################################################################

Room details:
Room 0: pos=(35,20) size=(4x10) center=(37,25) - Connected
Room 1: pos=(18,2) size=(7x8) center=(21,6) - Connected
Room 2: pos=(27,4) size=(6x6) center=(30,7) - Connected
Room 3: pos=(32,30) size=(8x5) center=(36,32) - Connected
Room 4: pos=(54,20) size=(4x10) center=(56,25) - Connected
Room 5: pos=(13,9) size=(4x10) center=(15,14) - Connected
Room 6: pos=(7,9) size=(6x10) center=(10,14) - Connected
Room 7: pos=(39,4) size=(4x6) center=(41,7) - Connected
Room 8: pos=(12,26) size=(8x7) center=(16,29) - Connected
Room 9: pos=(25,15) size=(7x6) center=(28,18) - Connected
