Configuration: game_config
Timestamp: 20250725_130122
Sample: 2
Total rooms: 9
Disconnected rooms: []
Width: 80, Height: 40
Room size: 4-10
Max rooms: 15

Map (numbers = room centers, X = disconnected areas):
################################################################################
################################################################################
################################################################################
####..####################......################################################
####..####################...7..###############....#############################
####..#######################...############.....8.#############################
####.1...........................###########.##....#############################
####..+########################...##########.###################################
####..#########################.....########.############################...####
###############################.#....#######.############################...####
###############################.##....######.############################...####
###############################.####...#####.############################...####
###############################.#####...####.###########################..6.####
###############################.######...###.#########################......####
###############################.#######...##.#######################........####
###############################.########.....#####################..........####
###############################.#########....###################......#...######
#############################.....####.......#################......###...######
#############################...............3.......########......####...#######
#############################..5................###.######......######...#######
#############################.........#####......##.####......########...#######
#############################.....#########..##......#......######......########
################################################..........########......########
#################################################.......................########
##################################################.4.................2..########
##################################################......................########
##################################################...#############......########
##################################################...###########################
##################################################...###########################
###################################################...##########################
###################################################...##########################
################################################........########################
################################################........########################
################################################........########################
################################################....0...########################
################################################........########################
################################################........########################
################################################################################
################################################################################
################################################################################

Room details:
Room 0: pos=(47,30) size=(10x8) center=(52,34) - Connected
Room 1: pos=(3,2) size=(4x8) center=(5,6) - Connected
Room 2: pos=(65,20) size=(8x8) center=(69,24) - Connected
Room 3: pos=(42,14) size=(4x9) center=(44,18) - Connected
Room 4: pos=(49,20) size=(5x8) center=(51,24) - Connected
Room 5: pos=(28,16) size=(7x7) center=(31,19) - Connected
Room 6: pos=(72,7) size=(5x10) center=(74,12) - Connected
Room 7: pos=(25,2) size=(8x4) center=(29,4) - Connected
Room 8: pos=(46,3) size=(6x5) center=(49,5) - Connected
