Configuration: medium_dungeon
Timestamp: 20250725_130122
Sample: 0
Total rooms: 8
Disconnected rooms: []
Width: 60, Height: 40
Room size: 4-8
Max rooms: 10

Map (numbers = room centers, X = disconnected areas):
############################################################
############################################################
############################################################
############################################################
############################################################
############################################......##########
############################################......##########
###############....#########################...1..##########
###############....################.....#.........##########
###############....################...............##########
###############..3.################........+#####.##########
###############....################..4...########.##########
###############....################.....#########.##########
#################.#################.....#########.##########
#################.###################.#########.....########
#################.###################.#########.....########
#################.###################.#########..0..########
#################.#######....########.#########.....########
#################..........5..........######################
###########################.################################
###########################.################################
###########################.################################
###########################.################################
###########################.################################
###########################.################################
###########################.################################
###########################.################################
###########################.#####..#########################
###########################.......7..................#######
#################################..#####.###########.#######
########################################+###########.#######
#######################################...##########.#######
#######################################...+#########.#######
#######################################.....########.#######
#######################################.2.........#..#######
#######################################..............#######
#######################################...##........6#######
##################################################...#######
############################################################
############################################################

Room details:
Room 0: pos=(46,13) size=(7x6) center=(49,16) - Connected
Room 1: pos=(43,4) size=(8x7) center=(47,7) - Connected
Room 2: pos=(38,30) size=(5x8) center=(40,34) - Connected
Room 3: pos=(14,6) size=(6x8) center=(17,10) - Connected
Room 4: pos=(34,7) size=(7x8) center=(37,11) - Connected
Room 5: pos=(24,16) size=(6x4) center=(27,18) - Connected
Room 6: pos=(50,33) size=(4x6) center=(52,36) - Connected
Room 7: pos=(32,26) size=(4x5) center=(34,28) - Connected
