Configuration: medium_dungeon
Timestamp: 20250725_130122
Sample: 1
Total rooms: 8
Disconnected rooms: []
Width: 60, Height: 40
Room size: 4-8
Max rooms: 10

Map (numbers = room centers, X = disconnected areas):
############################################################
############################################################
############################################################
###############...##########################################
#####...........1.##########################################
#####.######################################################
#####.######################################################
#####.######################################################
#####.######################################################
#####.######################################################
#####.######################################################
#####.###########################################......#####
####+.###########################################......#####
###.....#########################################...3..#####
###.....#########################################......#####
###..0..#####################....#################+...######
###.....#####################....##################...######
###.....#####################....#################...#######
####...######################..2.#################...#######
####...######################.....################...#######
####...######################.....################...#######
####...########################+...###############...#######
####...#########################...###############...#######
#####...#########################...#############...########
#####...#########################...#############...########
#####...##########################...############...########
#####...##########################...############...########
####+...##########################......#########...########
####....##########################......#########...########
####....###########..................6..............########
####..7..##########.##############......########...#########
####.......########.############################...#########
####.........######.############################...#########
#########......####.############################.4.#########
###########......##.############################..+#########
#############.......########################################
###############......#######################################
#################..5.#######################################
############################################################
############################################################

Room details:
Room 0: pos=(2,12) size=(7x7) center=(5,15) - Connected
Room 1: pos=(14,2) size=(5x4) center=(16,4) - Connected
Room 2: pos=(28,14) size=(6x8) center=(31,18) - Connected
Room 3: pos=(48,10) size=(8x6) center=(52,13) - Connected
Room 4: pos=(47,31) size=(4x5) center=(49,33) - Connected
Room 5: pos=(16,35) size=(6x4) center=(19,37) - Connected
Room 6: pos=(33,26) size=(8x6) center=(37,29) - Connected
Room 7: pos=(3,27) size=(6x7) center=(6,30) - Connected
