Configuration: medium_dungeon
Timestamp: 20250725_130122
Sample: 2
Total rooms: 7
Disconnected rooms: []
Width: 60, Height: 40
Room size: 4-8
Max rooms: 10

Map (numbers = room centers, X = disconnected areas):
############################################################
############################################################
############################################################
############################################################
############################################################
############################################################
############################################################
############################################################
############################################################
############################################################
############################################################
########...##################################..#############
########...##################################.5.############
########.1.##################################...############
########...#####...#########################.....###########
#########........3....######################.....###########
##################.......##################...#...##########
###################.............###########...#...##########
######################...........#########...###...#########
#########################....4.........##....###...#########
##########################..................#####...########
############################...##.........6.#####...########
############################...########......####...########
############################...##########......###...#######
############################...#############....##...#######
############################...##############....##...######
############################...################...#...######
############################...#################...#...#####
#############################...#################......#####
#############################...##################......####
#############################...###################.....####
#############################...####################......##
#############################...####################...0..##
############################.....######################.####
############################.....###########################
############################..2..###########################
############################.....###########################
############################.....###########################
############################################################
############################################################

Room details:
Room 0: pos=(51,30) size=(8x4) center=(55,32) - Connected
Room 1: pos=(7,10) size=(5x6) center=(9,13) - Connected
Room 2: pos=(27,32) size=(7x7) center=(30,35) - Connected
Room 3: pos=(15,13) size=(4x4) center=(17,15) - Connected
Room 4: pos=(25,16) size=(8x6) center=(29,19) - Connected
Room 5: pos=(44,10) size=(4x4) center=(46,12) - Connected
Room 6: pos=(40,18) size=(5x7) center=(42,21) - Connected
