Configuration: small_dungeon
Timestamp: 20250725_130122
Sample: 0
Total rooms: 5
Disconnected rooms: []
Width: 40, Height: 25
Room size: 3-6
Max rooms: 5

Map (numbers = room centers, X = disconnected areas):
########################################
########################################
########################################
###################################.####
###################################1####
##################################...###
##################################...###
##################################...###
#############.####################...###
#############.####################...###
############.0####################...###
############..####################...###
############.######################...##
############.######################...##
############+######################...##
############3+......###############...##
##################..###############...##
##################..###############...##
##################.4..................##
##################..###############...##
###################################.2.##
####################################.###
########################################
########################################
########################################

Room details:
Room 0: pos=(12,7) size=(3x6) center=(13,10) - Connected
Room 1: pos=(34,2) size=(3x4) center=(35,4) - Connected
Room 2: pos=(35,18) size=(3x5) center=(36,20) - Connected
Room 3: pos=(11,14) size=(3x3) center=(12,15) - Connected
Room 4: pos=(17,15) size=(4x6) center=(19,18) - Connected
