Configuration: small_dungeon
Timestamp: 20250725_130122
Sample: 2
Total rooms: 4
Disconnected rooms: []
Width: 40, Height: 25
Room size: 3-6
Max rooms: 5

Map (numbers = room centers, X = disconnected areas):
########################################
########################################
########################################
########################################
########################################
########################################
########################################
##################....##################
################....3........###########
################.#....######.###########
################.###########.###########
################.##########+.###########
################.#########....##########
################.#########....##########
################.#########..1.##########
################.#########....##########
##.2.............##########+.###########
################.###########.###########
################.###########.###########
################.###########.###########
################0............###########
################.#######################
########################################
########################################
########################################

Room details:
Room 0: pos=(15,18) size=(3x5) center=(16,20) - Connected
Room 1: pos=(25,11) size=(6x6) center=(28,14) - Connected
Room 2: pos=(1,15) size=(5x3) center=(3,16) - Connected
Room 3: pos=(17,6) size=(6x5) center=(20,8) - Connected
