Configuration: small_dungeon
Timestamp: 20250725_130122
Sample: 1
Total rooms: 3
Disconnected rooms: []
Width: 40, Height: 25
Room size: 3-6
Max rooms: 5

Map (numbers = room centers, X = disconnected areas):
########################################
########################################
########################################
########################################
###################............0.#######
###################.####################
###################.####################
###################.####################
###################.####################
###################.####################
###################.####################
#######.###########.####################
######1....########.####################
#######........####.####################
########..........#.####################
###########.........####################
###############....2####################
##################..####################
########################################
########################################
########################################
########################################
########################################
########################################
########################################

Room details:
Room 0: pos=(29,3) size=(5x3) center=(31,4) - Connected
Room 1: pos=(5,11) size=(3x3) center=(6,12) - Connected
Room 2: pos=(18,15) size=(3x3) center=(19,16) - Connected
